111111111111111
10000000C000001
100C00P00000001
1000000000E0001
111111111111111