11111111
10000P01
1E000001
11111111